11111111111111111111111111111111111111111111111111111111
100000P000000000000000000000000000000000000C000011111111
10000000000000000000000000000000000000000000000000001111
10000000000000000000000000000000000000000000000000000001
10000000000000000000000000000000000000000000000000000001
10000000000000000000000000000000000000000000000000000001
10000000000000000000000000000000000000000000000000000001
10000000000000000000000000000000000000000000000000000001
10000000000000000000000000000000000000000000000000000001
10000000000000000000000000000000000000000000000000000001
10000000000000000000000000000000000000000000000000000001
10000000000000000000000000000000000000000000000000000001
100000E0000000000000000000000000000000000000000000000001
11111111111111111111111111111111111111111111111111111111