111111111111111111111111111111
1P00E00000000X0000000111111111
1010000X00000000C0000111111111
1110000000X0000X00000CCCC11111
100CC00C00X00C000C000111111111
110000000011111111111111111111
111111000C0000000C111111111111
111111111111111111111111111111