111111111111111111111111111111111111
11000000C11C000C11111111111111111111
111CX001111101111C000000X000XC111111
1111100000X0000000CX1110000111111111
1EX011111111111C00000000000000000001
1X00000000X00000000011110000000000P1
111111111111111111111111111111111111